######################     #######################
#                                                #
#                                                #
########################   #######################
########################   #######################
########################   #######################
########################   #######################
########################   #######################
#######################    #######################
########################  ########################
######################     #######################
#                                                #
#                                                #
######################     #######################
#                                                #
#                                                #
######################     #######################
#                                                #
#                                                #
######################     #######################
#                                                #
#                                                #
######################     #######################
#                                                #
#                       j                        #
######################     #######################
#                                                #
#                                                #
######################     #######################
#                                                #
#                                                #
######################     #######################
#                                                #
#                                                #
######################     #######################
#                                                #
#                                                #
######################     #######################
#                                                #
#                                                #
######################     #######################
#                                                #
#                                                #
######################     #######################
#                                                #
#                                                #
######################     #######################
#                                                #
##################################################
##################################################
