######################     #######################
#                                                #
#                       j                        #
##################################################
##################################################
