##################################################
################                                 #
#                                  ###############
####################          ####################
#################            #####################
#################             ####################
####################      ########################
###################        #######################
