##################################################
################                                 #
#                                  ###############
####################          ####################
#################            #####################
#################             ####################
######################     #######################
#                                                #
#                                                #
######################     #######################
#                                                #
#                                                #
######################     #######################
#                                                #
#                                                #
######################     #######################
#                                                #
#                                                #
######################     #######################
#                                                #
#                                                #
######################     #######################
#                                                 
#                                                 
#####                                             
#                                                 
#                                                 
#######                                   ########
#                                                #
#                                                #
#########                                      ###
#                                                #
#                                                #
##########                            ############
#                                                #
#                                                #
#########                                  #######
#                                                #
#                                                #
###############                      #############
#                                                #
#                                                #
######################     #######################
#                                                #
######################     #######################
#                                                #
#                                                #
######################     #######################
#                                                #
#####################       ######################
