p0 n0 s64
#######                                                 ########
#                                                #             #
#                                                #             #
########################   ########################            #
########################   #######################             #
########################   #######################             #
########################   #######################             #
########################   #######################             #
#######################    #######################             #
########################  ########################             #
######################     #######################             #
#                                                #             #
#                                                #             #
######################     #######################             #
#                                                #             #
#                                                #             #
######################     #######################             #
#                                                #             #
#                                                #             #
######################     #######################             #
#                                                #             #
#                                                #             #
######################     #######################             #
#                                                #             #
#                                                #             #
######################     #######################             #
#                                                              #
#                                                              #
#                                                              #
#                                                              #
#                            c                                 #
#                                                              #
#                                                              #
#                                                              #
######################     #######################             #
#                                                #             #
#                                                #             #
######################     #######################             #
#                                                #             #
#                                                #             #
######################     #######################             #
#                                                #             #
#                                                #             #
######################     #######################             #
#                                                #             #
#                                                #             #
######################     #######################             #
#                                                #             #
######################     #######################             #
######################     #######################             #
#                                                              #
#                                                              #
#                                                              #
#                                                              #
#                                                              #
#                                                              #
#                                                              #
#                                                              #
#                                                              #
#                                                              #
#                                                              #
#                                                              #
#                                                              #
########################               #########################
