p2 n0 s64
######################               ###########################
#                                                #             #
#                        v                       #             #
########################   ########################            #
########################   #######################             #
########################   #######################             #
########################   #######################             #
########################   #######################             #
#######################    #######################             #
########################  ########################             #
######################     #######################             #
#               m               c                #             #
#                                                #             #
######################     #######################             #
#                                                #             #
#                                                #             #
######################     #######################             #
#                                                #             #
#                                                #             #
######################     #######################             #
#                                                #             #
#                                                #             #
######################     #######################             #
#                                                #             #
#                                                #             #
###                                                            #
#                                                              #
#                                                              #
#                                                              #
#                                                              #
#                                                              #
#                                                              #
#                                                              #
#                                                              #
#                                                              #
#                                                              #
#                                                              #
#                                                              #
#                                                              #
#                                                              #
#                                                              #
#                                                              #
#                                                              #
#                                                              #
#                                                              #
#                                                              #
#                                                              #
#                                                              #
#                                                              #
#                                                              #
#                                                              #
#                                                              #
#                                                              #
#                                                              #
#                                                              #
#                                                              #
#                                                              #
#                                                              #
#                                                              #
#                                                              #
#                                                              #
#                                                              #
###################                        #####################
################                         #######################
